11:1:1-53
11:2:1-46
11:3:1-28
11:4:1-34
11:5:1-18
11:6:1-38
11:7:1-51
11:8:1-66
11:9:1-28
11:10:1-29
11:11:1-43
11:12:1-33
11:13:1-34
11:14:1-31
11:15:1-34
11:16:1-34
11:17:1-24
11:18:1-46
11:19:1-21
11:20:1-43
11:21:1-29
11:22:1-53