17:1:1-22
17:2:1-23
17:3:1-15
17:4:1-17
17:5:1-14
17:6:1-14
17:7:1-10
17:8:1-17
17:9:1-32
17:10:1-3